2 4 5612 2462 4408 4735 
2 5 5314 5138 3576 5093 3508 
2 8 3508 9541 9510 9520 3872 9531 6439 1656 
2 4 6191 1342 9544 6210 
1 2 6210 4158 
2 8 4158 3288 9491 1259 9498 9522 9533 5579 
2 6 5579 9557 9562 1251 9532 1656 
2 8 4158 9466 1018 9370 9322 9268 1203 9158 
2 10 4859 9142 3946 9225 850 9293 9344 9415 9454 5579 
2 3 4859 9117 9158 
2 6 9158 9177 9188 3019 3497 9259 
2 5 9158 4832 9025 8931 5334 
2 6 5612 8797 4118 8903 9014 4859 
2 10 4735 8424 8494 8501 3481 5346 8399 3064 8391 6280 
2 4 2832 8726 3568 3653 
2 11 3653 8796 8805 5048 5985 3139 3859 5291 8779 8727 5612 
2 17 5307 8543 6196 8566 5614 8618 8554 8601 8567 8531 8568 577 5379 8569 8570 4408 4735 
1 6 8847 3859 5291 8779 8727 5612 
2 6 8847 8929 8976 9013 9070 9079 
2 11 5314 9291 9248 5828 9114 5822 3558 6152 8945 8887 8847 
2 6 9115 4240 9002 8958 5426 8847 
1 4 9115 4678 9130 9114 
2 9 4859 5126 9057 3975 9056 2336 4987 9141 9115 
2 5 8657 2301 8753 8812 5334 
2 6 8657 1965 8638 2772 10601 4735 
2 5 4735 2609 4617 8459 5397 
2 9 8511 5797 5286 4011 4581 3842 8510 10601 4735 
2 7 5397 8383 8339 3684 3266 403 7 
2 5 4928 5589 8316 2324 5397 
2 5 4928 3936 6408 5345 4563 
2 5 8066 275 6408 3936 4928 
2 3 8122 8163 6408 
2 5 6038 8345 8401 8424 4735 
1 5 8358 5181 8401 8424 4735 
2 2 8510 4617 
2 2 1965 3842 
2 2 8345 4928 
2 6 5334 8854 5708 2007 8770 8780 
2 10 8657 8683 8695 3471 8761 5173 4142 5767 8770 8780 
1 2 8511 1526 
2 6 5314 5138 2741 9414 342 1656 
2 7 1656 342 9350 9292 4644 9166 9115 
2 2 7 4747 
1 4 3103 8103 2673 7 
1 4 4563 8152 2673 7 
2 7 7 403 2723 8247 8297 8340 8306 
1 5 6034 8090 3058 8089 7 
1 4 5286 865 4282 8306 
2 3 9764 3511 9708 
1 5 8672 4361 8762 8771 8742 
2 11 8742 8781 8741 6208 8754 8697 4015 5557 5514 3989 8512 
1 5 8697 8696 4438 8740 8780 
1 4 8532 8502 8448 5514 
1 5 8306 5213 8257 4491 4579 
2 3 2138 8164 4579 
1 2 2138 5801 
1 2 2138 8022 
2 2 8022 7936 
2 4 8022 7970 7971 7948 
1 7 5305 8173 8123 4860 8015 7957 7948 
1 7 7948 3444 7815 5900 4842 4992 7610 
1 2 7610 5517 
2 5 5517 6447 7543 967 7509 
1 7 7509 7471 7483 3363 7433 5134 6321 
1 3 7509 7400 6453 
1 5 7509 5429 7389 4864 7277 
2 5 5305 5044 5952 3989 8512 
1 7 8512 4585 8412 8317 8348 1579 8385 
2 5 8385 8430 5166 4002 8513 
1 5 8513 8556 5454 8719 8672 
1 5 8672 8719 4630 8720 8708 
1 4 8513 5123 8659 8708 
1 3 8513 8503 1553 
1 6 8574 4956 3949 8486 8476 8385 
2 3 8512 8525 8574 
1 4 8574 8629 4107 8742 
1 6 4860 8092 8024 2529 86 7972 
1 6 2529 7937 6109 7827 7784 4452 
1 5 4452 3231 7636 7586 5517 
1 4 4452 3985 967 7509 
1 5 4452 6350 3774 3483 7764 
1 6 7764 6312 1246 7575 3940 7433 
1 3 7575 7561 7483 
3 6 7764 7806 7785 7775 7766 2046 
3 5 2046 6296 1535 6011 4665 
1 6 2046 7650 7621 3959 7434 6321 
2 7 6321 7355 7380 213 5299 7484 4665 
2 9 4665 7485 3556 3152 1052 7376 7381 2487 7335 
1 7 7335 3640 7303 4327 7321 4868 934 
1 5 3182 5818 7391 7343 7304 
2 6 7304 1518 7344 7311 4607 7358 
1 5 7304 7267 4906 3618 5938 
2 6 934 7357 5073 6332 7331 7304 
1 5 6376 7787 963 5730 7628 
1 6 7628 4882 7548 680 2231 934 
2 10 6376 7720 7767 2385 7776 7760 2463 7709 7719 2046 
1 4 7973 4699 7794 2046 
1 4 7949 7925 4211 3315 
2 8 8385 2426 8259 8215 8093 7861 3215 3315 
1 3 7972 6314 3315 
1 3 7972 2892 3774 
1 4 3315 7897 6235 3774 
1 3 7815 7805 7827 
1 10 7970 6273 7860 7740 6263 3890 7560 1103 7482 7610 
1 9 6376 7787 7839 3512 4407 6389 2977 4230 8176 
1 2 8176 3947 
1 4 5305 8229 405 8317 
1 4 2983 2463 6011 4665 
1 11 2983 7760 3038 3647 3920 6068 7588 7528 5192 7435 2231 
1 4 1526 3844 8555 8532 
2 2 9735 3124 
1 3 9735 9755 3329 
1 5 3329 9771 9792 2048 9856 
2 12 5807 10030 10011 3874 9982 9960 3361 3374 5097 1655 9853 9856 
1 8 9982 6028 1313 9949 9912 3915 9858 2 
1 3 2 4119 10112 
2 5 9858 2156 9822 5878 9766 
2 4 2048 9815 9787 9766 
1 4 9766 9765 3723 5675 
1 5 5675 2325 5775 9563 2927 
1 4 2927 5882 9450 5018 
2 3 5018 5515 9372 
1 4 2592 9456 9399 9372 
1 7 3124 3123 3764 9587 9545 9502 2592 
1 4 4224 5257 3123 3124 
1 4 4224 5537 2499 9438 
2 4 9438 4762 6288 9383 
1 6 6191 9467 9437 4468 9376 9383 
1 5 9383 5498 9260 9279 9269 
2 3 9260 5077 2417 
2 6 2417 9168 3156 5548 5278 8986 
1 3 2417 9198 9132 
1 8 9372 9365 4049 2268 3470 9212 9198 2417 
1 4 9372 9325 3129 9178 
1 5 9178 4570 9099 9122 5619 
1 4 9383 4172 9280 2417 
1 6 9280 3170 9309 5351 9365 9372 
1 6 9735 6426 6413 5576 9534 2927 
2 6 10043 3357 5167 10040 10054 10028 
1 7 4086 9944 3579 3596 9872 1331 9798 
1 4 9269 3012 9296 9259 
2 5 3447 9600 5263 4409 9486 
1 7 5082 9711 9686 9648 3145 9526 9486 
1 4 9486 9419 5401 2466 
2 4 2466 9285 2894 830 
1 6 830 6315 9052 8998 4019 1751 
1 9 1595 4526 9123 9092 1915 8961 8922 8905 1751 
1 8 5191 4622 3840 3001 1290 9213 1909 4341 
2 4 1595 1806 5398 4341 
1 3 5619 4050 4341 
1 5 8988 5961 9005 4062 9099 
1 8 8988 2011 8877 8822 8785 5663 4914 8674 
1 5 3104 6265 670 8731 8674 
2 5 3104 3735 9006 1806 1595 
1 9 8674 1536 5423 8478 8514 8393 1309 6386 8199 
2 4 8393 4615 3006 8260 
1 7 8260 2322 2588 8181 6371 8223 8215 
1 3 8260 8224 8199 
2 5 8199 8175 3845 5760 7973 
2 7 4911 3091 3816 4202 8249 8200 8176 
1 8 8199 3719 223 8230 2503 8261 8236 3091 
1 5 8674 2528 5758 44 4911 
1 2 2528 8620 
2 8 8620 4371 8590 5808 8582 8591 8534 2770 
1 6 2770 4702 8416 4934 8349 4202 
1 5 2770 2705 2948 8467 8405 
1 5 8405 4185 2596 8632 3965 
1 4 3965 8799 5171 8895 
1 5 8895 4278 8896 8937 8968 
2 7 1751 8836 5114 6251 6179 2334 8895 
1 8 1751 3027 5580 8698 8685 8648 8631 8620 
1 4 9201 9239 4798 2894 
1 16 9379 5341 9442 4462 1245 4719 2074 9401 9393 1792 4571 9313 3592 9301 9240 9201 
1 5 9379 4931 9394 9426 9443 
1 10 8968 4874 5823 9103 9180 9203 9264 9315 9340 9379 
1 6 9379 5913 3740 9302 9253 9217 
1 10 9217 2676 3219 9009 3657 8868 5264 6446 8764 2643 
1 2 5208 5191 
1 9 8513 8503 1553 2785 8589 8684 2688 4914 8674 
1 4 4389 4564 8813 8857 
1 5 8857 4898 8814 2807 8773 
1 4 8773 4321 8729 2967 
1 7 2967 8647 5743 8684 2688 4914 8674 
1 6 1516 5411 885 4843 1978 1581 
1 8 1581 10355 3853 2257 3165 10120 10140 1030 
1 9 10637 10668 10683 10647 10652 10648 10612 10577 10552 
1 6 10552 4844 10728 10481 10752 2886 
1 2 2886 2112 
1 5 2886 10315 2546 4352 5311 
2 3 5311 10113 2403 
1 3 10113 2922 10049 
1 11 360 1209 1105 10025 5672 251 3105 4838 2403 10113 5311 
1 4 360 5098 2845 6328 
1 4 2845 4623 9875 1902 
2 14 5332 9818 9805 9796 4881 3351 9774 9750 4890 9778 161 9777 255 9715 
2 5 3447 4952 9677 9663 9715 
1 12 10037 10022 10019 10001 784 2135 6194 9929 5733 5089 5281 5356 
1 7 5082 9744 6267 9794 9800 3727 5281 
1 13 3447 4952 9677 9663 6025 9664 3251 6400 6166 4260 5941 9549 3409 
2 3 9947 5960 495 
2 4 9947 5905 1298 5672 
1 3 1902 9875 9947 
1 4 495 3278 9810 4041 
1 5 495 808 1346 1966 3250 
1 3 2563 2372 5321 
1 4 10751 4370 2678 10637 
2 6 10751 10744 10712 6172 4236 10635 
1 12 10751 10773 1632 10812 10824 6018 1472 4058 67 10927 10938 10949 
1 4 10744 3828 10700 10646 
2 9 9984 5024 6177 3865 9904 9881 5451 4023 2467 
1 5 3861 9964 5053 5024 9984 
1 6 10087 4688 6434 10023 4390 5024 
2 2 2467 5727 
1 3 2467 5296 5008 
