2 4 5612 2462 4408 4735 
2 5 5314 5138 3576 5093 3508 
2 8 3508 9541 9510 9520 3872 9531 6439 1656 
2 4 6191 1342 9544 6210 
1 2 6210 4158 
2 8 4158 3288 9491 1259 9498 9522 9533 5579 
2 6 5579 9557 9562 1251 9532 1656 
2 8 4158 9466 1018 9370 9322 9268 1203 9158 
2 10 4859 9142 3946 9225 850 9293 9344 9415 9454 5579 
2 3 4859 9117 9158 
2 6 9158 9177 9188 3019 3497 9259 
2 5 9158 4832 9025 8931 5334 
2 6 5612 8797 4118 8903 9014 4859 
2 10 4735 8424 8494 8501 3481 5346 8399 3064 8391 6280 
2 4 2832 8726 3568 3653 
2 11 3653 8796 8805 5048 5985 3139 3859 5291 8779 8727 5612 
2 17 5307 8543 6196 8566 5614 8618 8554 8601 8567 8531 8568 577 5379 8569 8570 4408 4735 
1 6 8847 3859 5291 8779 8727 5612 
2 6 8847 8929 8976 9013 9070 9079 
2 11 5314 9291 9248 5828 9114 5822 3558 6152 8945 8887 8847 
2 6 9115 4240 9002 8958 5426 8847 
1 4 9115 4678 9130 9114 
2 9 4859 5126 9057 3975 9056 2336 4987 9141 9115 
2 5 8657 2301 8753 8812 5334 
2 6 8657 1965 8638 2772 10601 4735 
2 5 4735 2609 4617 8459 5397 
2 9 8511 5797 5286 4011 4581 3842 8510 10601 4735 
2 7 5397 8383 8339 3684 3266 403 7 
2 5 4928 5589 8316 2324 5397 
2 5 4928 3936 6408 5345 4563 
2 5 8066 275 6408 3936 4928 
2 3 8122 8163 6408 
2 5 6038 8345 8401 8424 4735 
1 5 8358 5181 8401 8424 4735 
2 2 8510 4617 
2 2 1965 3842 
2 2 8345 4928 
2 6 5334 8854 5708 2007 8770 8780 
2 10 8657 8683 8695 3471 8761 5173 4142 5767 8770 8780 
1 2 8511 1526 
2 6 5314 5138 2741 9414 342 1656 
2 7 1656 342 9350 9292 4644 9166 9115 
2 2 7 4747 
1 4 3103 8103 2673 7 
1 4 4563 8152 2673 7 
2 7 7 403 2723 8247 8297 8340 8306 
1 5 6034 8090 3058 8089 7 
1 4 5286 865 4282 8306 
2 3 9764 3511 9708 
1 5 8672 4361 8762 8771 8742 
2 11 8742 8781 8741 6208 8754 8697 4015 5557 5514 3989 8512 
1 5 8697 8696 4438 8740 8780 
1 4 8532 8502 8448 5514 
1 5 8306 5213 8257 4491 4579 
2 3 2138 8164 4579 
1 2 2138 5801 
1 2 2138 8022 
2 2 8022 7936 
2 4 8022 7970 7971 7948 
1 7 5305 8173 8123 4860 8015 7957 7948 
1 7 7948 3444 7815 5900 4842 4992 7610 
1 2 7610 5517 
2 5 5517 6447 7543 967 7509 
1 7 7509 7471 7483 3363 7433 5134 6321 
1 3 7509 7400 6453 
1 5 7509 5429 7389 4864 7277 
2 5 5305 5044 5952 3989 8512 
1 7 8512 4585 8412 8317 8348 1579 8385 
2 5 8385 8430 5166 4002 8513 
1 5 8513 8556 5454 8719 8672 
1 5 8672 8719 4630 8720 8708 
1 4 8513 5123 8659 8708 
1 3 8513 8503 1553 
1 6 8574 4956 3949 8486 8476 8385 
2 3 8512 8525 8574 
1 4 8574 8629 4107 8742 
1 6 4860 8092 8024 2529 86 7972 
1 6 2529 7937 6109 7827 7784 4452 
1 5 4452 3231 7636 7586 5517 
1 4 4452 3985 967 7509 
1 5 4452 6350 3774 3483 7764 
1 6 7764 6312 1246 7575 3940 7433 
1 3 7575 7561 7483 
3 6 7764 7806 7785 7775 7766 2046 
3 5 2046 6296 1535 6011 4665 
1 6 2046 7650 7621 3959 7434 6321 
2 7 6321 7355 7380 213 5299 7484 4665 
2 9 4665 7485 3556 3152 1052 7376 7381 2487 7335 
1 7 7335 3640 7303 4327 7321 4868 934 
1 10 7304 7343 7391 5818 3182 7583 7629 4601 7750 7795 
2 9 7304 1518 7344 7311 4607 7358 7307 6114 7246 
1 7 7304 7267 4906 3618 5938 1685 796 
2 6 934 7357 5073 6332 7331 7304 
1 5 6376 7787 963 5730 7628 
2 6 7628 4882 7548 680 2231 934 
2 10 6376 7720 7767 2385 7776 7760 2463 7709 7719 2046 
1 4 7973 4699 7794 2046 
1 4 7949 7925 4211 3315 
2 8 8385 2426 8259 8215 8093 7861 3215 3315 
1 3 7972 6314 3315 
1 3 7972 2892 3774 
1 4 3315 7897 6235 3774 
1 3 7815 7805 7827 
1 10 7970 6273 7860 7740 6263 3890 7560 1103 7482 7610 
1 9 6376 7787 7839 3512 4407 6389 2977 4230 8176 
1 2 8176 3947 
1 4 5305 8229 405 8317 
1 4 2983 2463 6011 4665 
1 11 2983 7760 3038 3647 3920 6068 7588 7528 5192 7435 2231 
1 4 1526 3844 8555 8532 
2 2 9735 3124 
1 3 9735 9755 3329 
1 5 3329 9771 9792 2048 9856 
2 12 5807 10030 10011 3874 9982 9960 3361 3374 5097 1655 9853 9856 
1 8 9982 6028 1313 9949 9912 3915 9858 2 
1 3 2 4119 10112 
2 5 9858 2156 9822 5878 9766 
2 4 2048 9815 9787 9766 
1 4 9766 9765 3723 5675 
1 5 5675 2325 5775 9563 2927 
1 4 2927 5882 9450 5018 
2 3 5018 5515 9372 
1 4 2592 9456 9399 9372 
1 7 3124 3123 3764 9587 9545 9502 2592 
1 4 4224 5257 3123 3124 
1 4 4224 5537 2499 9438 
2 4 9438 4762 6288 9383 
1 6 6191 9467 9437 4468 9376 9383 
1 5 9383 5498 9260 9279 9269 
2 3 9260 5077 2417 
2 6 2417 9168 3156 5548 5278 8986 
1 3 2417 9198 9132 
1 8 9372 9365 4049 2268 3470 9212 9198 2417 
1 4 9372 9325 3129 9178 
1 5 9178 4570 9099 9122 5619 
1 4 9383 4172 9280 2417 
1 6 9280 3170 9309 5351 9365 9372 
1 6 9735 6426 6413 5576 9534 2927 
2 6 10043 3357 5167 10040 10054 10028 
1 7 4086 9944 3579 3596 9872 1331 9798 
1 4 9269 3012 9296 9259 
2 5 3447 9600 5263 4409 9486 
1 7 5082 9711 9686 9648 3145 9526 9486 
1 4 9486 9419 5401 2466 
2 4 2466 9285 2894 830 
1 6 830 6315 9052 8998 4019 1751 
1 9 1595 4526 9123 9092 1915 8961 8922 8905 1751 
1 8 5191 4622 3840 3001 1290 9213 1909 4341 
2 4 1595 1806 5398 4341 
1 3 5619 4050 4341 
1 5 8988 5961 9005 4062 9099 
1 8 8988 2011 8877 8822 8785 5663 4914 8674 
1 5 3104 6265 670 8731 8674 
2 5 3104 3735 9006 1806 1595 
1 9 8674 1536 5423 8478 8514 8393 1309 6386 8199 
2 4 8393 4615 3006 8260 
1 7 8260 2322 2588 8181 6371 8223 8215 
1 3 8260 8224 8199 
2 5 8199 8175 3845 5760 7973 
2 7 4911 3091 3816 4202 8249 8200 8176 
1 8 8199 3719 223 8230 2503 8261 8236 3091 
1 5 8674 2528 5758 44 4911 
1 2 2528 8620 
2 8 8620 4371 8590 5808 8582 8591 8534 2770 
1 6 2770 4702 8416 4934 8349 4202 
1 5 2770 2705 2948 8467 8405 
1 5 8405 4185 2596 8632 3965 
1 4 3965 8799 5171 8895 
1 5 8895 4278 8896 8937 8968 
2 7 1751 8836 5114 6251 6179 2334 8895 
1 8 1751 3027 5580 8698 8685 8648 8631 8620 
1 4 9201 9239 4798 2894 
1 16 9379 5341 9442 4462 1245 4719 2074 9401 9393 1792 4571 9313 3592 9301 9240 9201 
1 5 9379 4931 9394 9426 9443 
1 10 8968 4874 5823 9103 9180 9203 9264 9315 9340 9379 
1 6 9379 5913 3740 9302 9253 9217 
1 12 9217 2676 3219 9009 3657 8868 5264 6446 8764 2643 971 2750 
1 2 5208 5191 
1 9 8513 8503 1553 2785 8589 8684 2688 4914 8674 
1 4 4389 4564 8813 8857 
1 5 8857 4898 8814 2807 8773 
1 4 8773 4321 8729 2967 
1 7 2967 8647 5743 8684 2688 4914 8674 
1 6 1516 5411 885 4843 1978 1581 
1 8 1581 10355 3853 2257 3165 10120 10140 1030 
1 9 10637 10668 10683 10647 10652 10648 10612 10577 10552 
1 6 10552 4844 10728 10481 10752 2886 
1 2 2886 2112 
1 5 2886 10315 2546 4352 5311 
2 3 5311 10113 2403 
1 3 10113 2922 10049 
1 11 360 1209 1105 10025 5672 251 3105 4838 2403 10113 5311 
1 4 360 5098 2845 6328 
1 4 2845 4623 9875 1902 
2 14 5332 9818 9805 9796 4881 3351 9774 9750 4890 9778 161 9777 255 9715 
2 5 3447 4952 9677 9663 9715 
1 12 10037 10022 10019 10001 784 2135 6194 9929 5733 5089 5281 5356 
1 7 5082 9744 6267 9794 9800 3727 5281 
1 13 3447 4952 9677 9663 6025 9664 3251 6400 6166 4260 5941 9549 3409 
2 3 9947 5960 495 
2 4 9947 5905 1298 5672 
1 3 1902 9875 9947 
1 4 495 3278 9810 4041 
1 5 495 808 1346 1966 3250 
1 3 2563 2372 5321 
1 4 10751 4370 2678 10637 
2 6 10751 10744 10712 6172 4236 10635 
1 12 10751 10773 1632 10812 10824 6018 1472 4058 67 10927 10938 10949 
1 4 10744 3828 10700 10646 
2 9 9984 5024 6177 3865 9904 9881 5451 4023 2467 
1 5 3861 9964 5053 5024 9984 
1 6 10087 4688 6434 10023 4390 5024 
2 2 2467 5727 
1 3 2467 5296 5008 
2 2 10105 2396 
3 2 2396 10145 
2 3 10145 5350 10232 
2 3 10145 10138 774 
1 2 774 10123 
2 9 10123 5519 10141 529 10179 451 4527 2625 10122 
1 6 10123 10137 10128 10209 4264 2092 
2 7 10122 4495 5867 1226 10165 10195 10237 
1 8 10237 5231 1637 4244 10377 10513 10397 10396 
2 10 10237 10252 1747 10319 10419 10339 10375 10394 5360 4012 
1 5 4012 2597 544 10498 10462 
2 5 4774 5209 5306 2969 9769 
1 7 9769 941 922 2428 322 9967 9836 
2 6 9836 3903 644 4169 9603 5586 
1 3 5586 9508 2679 
1 7 5586 9445 6316 2931 9185 1811 5428 
1 7 5428 4655 8625 556 4760 8565 8553 
1 4 4518 9360 9330 9274 
2 14 2679 1168 9452 856 9434 6067 6099 4490 6452 1039 6443 9183 3895 9096 
1 7 9274 4285 9244 1665 3587 9107 9096 
4 5 8845 5633 9012 9022 9096 
1 14 9388 9336 9287 4557 5249 9128 3795 9067 5855 6323 5926 8871 5201 8679 
2 8 8679 6129 8701 8793 8737 3384 2989 8680 
1 6 8680 8688 8748 1723 283 8845 
2 5 8845 8795 5658 8689 5547 
1 9 5547 8636 3159 5266 8587 8598 8578 8579 8553 
2 8 8680 2606 8563 8507 2565 8409 8352 8253 
2 18 8679 8666 8653 4560 8562 2530 8506 8490 6112 8452 6410 8421 8331 8364 8219 6347 888 5558 
4 3 8218 8265 5558 
2 5 5558 8311 8377 8387 4804 
1 12 4804 8527 5577 8594 8652 6070 8758 3456 8898 8955 9000 9010 
1 11 4804 8442 3388 4977 5838 6084 5202 3799 8167 5973 16 
4 2 7795 7751 
2 5 7885 31 7840 7849 7795 
2 7 7885 3934 4156 7711 7662 4073 5901 
1 2 5901 680 
1 3 3947 8225 3420 
3 8 3420 4384 8192 8155 8117 8067 8018 7959 
2 4 7959 3952 7854 7795 
1 2 7959 7984 
2 5 7751 140 7907 7898 7984 
1 8 7751 2558 3518 7796 6289 5792 7873 7830 
2 5 7830 7797 7761 5736 3223 
1 14 3223 7599 7639 7600 7611 3056 1798 7578 1654 7565 5909 7489 7449 5621 
1 6 5621 1089 4270 211 1703 7323 
1 9 3223 7599 4998 7550 370 7462 1149 7372 7323 
1 5 7323 7312 7290 7260 7246 
2 5 7246 7216 6071 7165 3634 
1 6 3634 7115 7114 4069 7101 796 
1 5 3634 7116 5214 6379 7019 
2 8 7019 6991 5940 6936 6890 3451 2347 6775 
1 4 6775 1302 5437 6784 
1 5 6784 3560 6789 4448 3762 
2 5 3762 6786 6769 6752 6740 
4 2 2937 6740 
1 4 2937 6740 1947 10664 
1 10 6936 3395 6931 5946 6923 6912 4683 2712 6937 5602 
1 7 5602 6906 6877 114 6829 1868 3762 
2 14 1926 5140 4776 4263 7878 1185 7986 3290 8070 6002 5856 3127 2415 8218 
1 11 1926 3676 7476 7429 7386 7360 7314 7301 4867 7242 5198 
4 3 7155 7190 5198 
4 3 5198 7232 1990 
4 5 7155 7127 7110 4268 3671 
2 18 3671 3437 2220 5989 6989 6954 6941 3663 4648 2816 6806 4659 6165 6451 6778 1547 6763 10664 
2 14 5643 7292 7299 7255 7236 7218 1434 7207 4550 6421 7149 7134 5655 7155 
1 8 5643 1931 7276 7309 5718 7347 6091 5439 
1 4 5439 7346 1171 7262 
1 17 7155 7127 7110 1916 3923 4186 5618 7107 7106 7083 7070 7065 5475 2087 6173 4393 7078 
2 6 7262 2480 7172 5211 2025 7078 
1 12 7078 4754 2873 4489 6932 483 6879 5387 4873 6805 6793 6763 
2 7 5621 7436 2820 7382 5725 7428 5439 
1 5 8377 3699 6047 4508 8168 
2 10 8168 8118 2906 8044 4445 8053 5412 5294 7877 7842 
1 2 5459 7842 
1 8 7842 2288 3378 2837 7567 7531 2004 7436 
1 5 3378 953 3682 7464 5439 
1 6 5459 7752 7715 3770 7697 6340 
2 4 5459 3106 7963 6002 
2 6 7830 1110 1197 5852 8158 5973 
2 7 8168 3896 8193 5109 3625 8159 3799 
1 5 3625 3151 3877 5862 1593 
1 9 16 8323 8419 8488 8496 2580 8547 8584 2750 
2 13 16 2400 5146 8226 944 4323 8271 8263 4839 5608 8262 4968 3420 
2 5 3947 4105 8011 3546 7885 
2 4 5198 7249 1905 3099 
1 8 3099 7478 7536 7591 7642 6197 7654 7706 
2 6 7706 7753 7811 5649 3237 6187 
1 5 6187 1875 8128 5036 8253 
1 7 8253 5788 1849 8296 8333 3493 8379 
1 8 8379 6308 8388 3180 8295 1002 8266 2415 
1 14 7930 7987 4580 2994 8221 8276 8354 5711 6064 4295 4964 6030 8795 8845 
2 12 1990 4382 5088 5477 474 7537 7643 7700 7746 4215 7879 7930 
2 7 7155 5113 4812 7104 7080 107 4722 
1 5 4722 479 3661 43 6757 
1 23 6740 1947 10664 5986 2755 6738 6125 6748 6198 2108 6760 6761 6755 5385 5977 6782 4778 1456 3900 5815 1971 6766 6757 
1 4 6125 4314 2930 2364 
1 6 1625 7790 4415 10559 883 1893 
2 5 1625 2828 198 7209 7067 
1 7 1419 7036 2392 4942 1819 2890 7067 
2 2 1419 128 
1 5 53 2682 1934 4524 1519 
2 2 1519 7067 
2 2 1819 1378 
2 4 5427 1837 1558 1625 
1 4 5427 686 3369 447 
2 2 447 1812 
1 2 4052 5427 
2 4 4052 1852 6051 1980 
1 4 1980 10692 3798 166 
2 5 166 1880 602 2457 5445 
1 5 5445 778 521 675 3544 
1 4 6051 5223 1053 894 
2 2 5803 7792 
2 5 7792 7758 7718 1412 5646 
1 4 7792 5843 5510 731 
4 3 5803 3744 7791 
1 4 5645 7902 7846 7791 
2 2 7791 5746 
1 4 7803 7814 1480 5746 
1 6 7803 7881 7871 5891 6032 1317 
1 4 7803 4159 7774 7835 
1 9 7835 3304 2368 7646 872 7496 7443 7431 7425 
2 5 7425 5813 5873 5790 7412 
1 4 4999 7507 5005 7412 
1 5 7803 7756 1214 7658 4999 
1 5 4999 5574 4031 7757 7791 
1 4 7412 7388 5111 7342 
1 9 5803 6392 3869 7648 7593 7540 4765 4619 7388 
1 7 7412 7368 7329 7285 6287 5626 6054 
1 5 6054 4233 7111 4360 7096 
2 3 7100 5935 7072 
1 3 7096 7089 7072 
1 3 7072 2757 7057 
1 5 7072 7053 6993 2553 6946 
1 2 2933 7100 
1 11 2933 7146 7170 5773 7185 3400 4434 5782 7319 5813 7425 
1 6 7072 6142 7013 4065 5235 6962 
1 4 449 4122 373 688 
1 2 688 1350 
1 3 1350 2418 748 
1 2 748 3398 
2 4 245 1437 726 200 
1 3 688 2056 245 
1 4 200 418 918 271 
1 3 200 1748 456 
1 3 4823 2939 1338 
1 2 40 539 
1 5 539 364 1858 6190 3603 
1 7 456 2784 1890 340 695 3741 40 
1 8 6190 2040 3941 1388 1897 645 918 271 
1 5 271 5474 3067 1802 3398 
1 3 271 876 34 
1 6 3603 11130 1388 1897 645 876 
1 4 1824 5635 965 6710 
1 5 6710 6692 5124 2435 3643 
1 3 5102 1042 3643 
1 7 3643 1406 6639 6652 3621 1236 5219 
1 2 3621 6665 
1 3 6665 3465 4506 
1 5 4506 1833 6714 6720 2937 
1 4 4506 5186 5420 6668 
1 5 6668 648 684 2423 2737 
1 3 5219 6612 2737 
1 6 401 6607 2270 4566 47 2737 
1 5 5102 1042 1815 728 401 
1 5 401 6580 727 3655 5744 
1 15 9010 8993 8940 8915 8852 8802 5677 8735 8715 4718 1602 8724 8716 5201 8679 
